0,0,3,3,3,3,0,0,0
3,3,3,7,0,3,3,3,3
3,0,0,0,0,0,2,0,3
3,0,3,0,0,3,2,0,3
3,0,4,0,4,3,1,0,3
3,3,3,3,3,3,3,3,3






